網擎資訊	mailgates*	mail2000	mailaudit	mailcloud
綠色運算	nopam
鎧睿科技	lisomail	armorx
沛盛資訊	newermail
桓基科技	mailsherlock	spamsherlock	hgiga*
Mirapoint	mirapoint
Google	google	gsmtp
Microsoft	microsoft	outlook
Softmail	softmail
#MPOP3D	mpop3d
Postfix	postfix
Sendmail	sendmail
Dovecot	dovecot
none	Generic MTA
RaidenMAILD	raidenmaild
MailEnable	mailenable
hMailServer	hmail	hMailServer
HCL_Technologies	domino	lotus	HCL_Technologies
趨勢科技	trendmicro	trend micro	deep discovery	IMSVA
Hibox	hibox
Zarafa	zarafa	VVV
Barracuda	barracuda
FireEye	fireeyecloud	FireEye
寬華科技	spamwall
ZohoMail	zohomail
騰訊	foxmail	bizmx	qq
NortonLifeLock	messagelabs	NortonLifeLock
達友科技	forcepoint	Sophos
Seednet	Seednet	grnet
ENTmail	entmail
Cellopoint	Cellopoint
IceWarp	IceWarp
阿里雲	aliyun	AliMail
MDaemon	 MDaemon
捕夢網	pumo
Coremail	corpease	Coremail
TAP Gateway	TAP Gateway
匯智	cloudmax
Hinet	Hinet
Courier	courier	Courier
華兆科技	Winmail
U-Mail	U-Mail
OpenWebMail 	OpenWebMail
Plesk	plesk
==========================================================
網擎資訊	mailcloud
Microsoft	outlook
中華數位	sqr